{
	"doc": [
		"ground values are the selected images of the ground images, ie 0 means plains.png"
		,"height values of 1 are compatible with the mouse cursor, so the bottom of tiles should be at this level, and tutorial should explain that the mouse pointer is to point there"
	],
	"ground": [
		[0,0,0,0,0,0,0,0,0,0]
		,[0,0,0,0,0,0,0,0,0,0]
		,[0,0,0,0,0,0,0,0,0,0]
		,[0,0,0,0,0,0,0,0,0,0]
		,[0,0,0,0,0,0,0,0,0,0]
		,[0,0,0,0,0,0,0,0,0,0]
		,[0,0,0,0,0,0,0,0,0,0]
		,[0,0,0,0,0,0,0,0,0,0]
		,[0,0,0,0,0,0,0,0,0,0]
		,[0,0,0,0,0,0,0,0,0,0]
	],
	"height": [
		[1,1,1,1,1,1,1,1,1,1]
		,[1,1,1,1,1,1,1,1,1,1]
		,[1,1,1,1,1,1,1,1,1,1]
		,[1,1,1,1,1,1,1,1,1,1]
		,[1,1,1,1,1,1,1,1,1,1]
		,[1,1,1,1,1,1,1,1,1,1]
		,[1,1,1,1,1,1,1,1,1,1]
		,[1,1,1,1,1,1,1,1,1,1]
		,[1,1,1,1,1,1,1,1,1,1]
		,[1,1,1,1,1,1,1,1,1,1]
	],
	"objects": [
		[2,2,2,2,2,3,3,3,3,3]
		,[2,2,2,2,2,2,2,2,2,2]
		,[2,3,3,3,3,3,3,3,3,2]
		,[2,3,3,3,3,3,3,3,3,2]
		,[2,3,3,3,3,3,3,3,3,2]
		,[2,3,3,3,3,3,3,3,3,2]
		,[2,2,2,2,2,2,2,2,2,2]
		,[2,3,3,3,3,3,3,3,3,3]
		,[2,3,3,3,3,3,3,3,3,3]
		,[2,2,2,2,2,2,3,3,3,3]
	]
}
